NO ./textures/b4.xpm
SO ./textures/b2.xpm
WE ./textures/b3.xpm
EA ./textures/b1.xpm
F 139,184,118
C 143, 182, 185


11111111111111111111111111
10000010000000001000000001
11110010111111101010111101
10000010100000101010111101
10000110111011101010111101
10000000000000000000001101
11111011000000000000001101
10000001000001001111111101
10000001000001000000001101
10000001000001000110001101
11111111111011111111111101
          101          101
          101          101
          101          101
          101          101
          101          101
     1111110111111     101
     1111110000001     101
     1111100000001     101
     111100000000111111101
     111000000000000000001
     110000N00000111111111
     1111111111111