NO ./textures/b4.xpm
SO ./textures/b2.xpm
WE ./textures/b3.xpm
EA ./textures/b1.xpm

F 139,184,118
C 143, 182, 185





111111111111111111111111111111111111111111111111111111111111111111
100000000000000000000000000000100000000000000000000000000000000001
100001000010000111111111100000100000111111111111111111111111100001
100001000010000100000000000000100000000000000000000000000000100001
100001000011111111111111111111100001111111111111111111110000100001
100001000000000000000000000000000001000000000000000000010000100001
100001111111111111111111111111111111111100000111111111110000100001
100001000000000000001000000000000000000000000100000000010000100001
100001111111111000001000010000111111111110000100001000010000111111
100001000000000000001000010000100000000010000100001000010000000001
100001000001111111111000010000111110000010000100001000010000100001
100001000000000000000000010000100000000010000100001000010000100001
100001111111111111111111110000100000111110000100001000010000100001
100000000000000000000000000000100000000000000100001000010000100001
111111111111111111111111110000111111111111111100001000011111100001
100000000000000100000000010000100000000000000000001000010000000001
100001000010000100001000010000100001111111111111111000011111000001
100001000010000100001000010000100001000000000000001000000000000001
100001000010000100001000010000100001000001111111111111111111100001
100001000010000000001000010000100001000000000000000000000000100001
100001000011111111111111110000100001000011111111111000010000100001
100001000000000000000000000000100001000010000000001000010000100001
100001111111111111111111111111100001000010000100001000010000100001
100001000000000100000000000000100001000010000100001000010000100001
10000100001000011111111110000010000100001111110000100001111110S001
100000000010000000000000000000100001000000000000001000000000000001
111111111111111111111111111111111111111111111111111111111111111111